Inventory = Inventory
Equipment = Equipment
Front armor = Front armor
Rear armor = Rear armor
Left armor = Left armor
Right armor = Right armor
Tires armor = Tires armor
Wheel armor = Wheel armor
Max. speed = Max. speed
Acceleration = Acceleration
Deceleration = Deceleration
Maneuverability = Maneuverability
Damage = Damage
Equipment & Stats = Equipment & Stats
Are you sure you want to destroy the item ? = Are you sure you want to destroy the item ?
Yes = Yes
No = No
Modifiers = Modifiers
Play = Play
Options = Options
Quit = Quit
Offline = Offline
Online = Online
Join = Join
Create = Create
Back = Back
Sound volume = Sound volume
Enable fullscreen = Enable fullscreen
Resume = Resume
Back to menu = Back to menu