Inventory = Inventaire
Equipment = Equipement
Front armor = Armure frontale
Rear armor = Armure arrière
Left armor = Armure gauche
Right armor = Armure droite
Tires armor = Armure pneus
Wheel armor = Armure volant
Max. speed = Vitesse max.
Acceleration = Accélération
Deceleration = Décéleration
Maneuverability = Maniabilité
Damage = Dommage
Equipment & Stats = Equipement & Stats
Are you sure you want to destroy the item ? = Êtes-vous sûr de vouloir détruire l'objet ?
Yes = Oui
No = Non
Modifiers = Modificateurs
Play = Jouer
Options = Options
Quit = Quitter
Offline = Hors ligne
Online = En ligne
Join = Rejoindre
Create = Créer
Back = Retour
Sound volume = Volume sonore
Enable fullscreen = Activer plein écran
Resume = Reprendre
Back to menu = Retour au menu